                  +-------------+           +-------------+                                                          
                  |.............|           |.............|                                                          
                  |.............|           |.............|                                                          
                  |.............#############.............|                                                          
                  |.............|           |.............|                                                          
                  |.............|           |.............|                                                          
                  |.............|           |.............|                                                          
                  |.............|           |.............|                                                          
                  |.............|           |.............|                                                          
                  |.............|           |.............|                                                          
                  |.............|           |.............|                                                          
                  |.............|           |.............|                                                          
                  |.............|           |.............|                               +-------------+            
                  |.............|           |.............|                             +.................+          
                  |.............|           |.............|                           +....................+         
                  |.............|           |.............|                          +...........+............+      
                  |.............|           |.............|                         +..........+   +............+    
                  |.............|           |.............|                        +..........+     +............+   
                  |.............|           |.............|                       +----------+      +..........+     
                  |.............|           |.............|                                       +..........+       
                  |.............|           |.............|                                      +...........+       
                  |.............|           |.............|                                       +............+     
                  |.............|           |.............|                                         +............+   
+----------+      |.............|           |.............+----------------------+ +----------+      +...........+   
+..........+     +.............+            |....................................| +..........+     +............+   
+...........+   +.............+             |....................................####..........+   +............+    
  +...........+.............+               |....................................|   +...........+.............+     
   +......................+                 |....................................|     +.....................+       
    +...................+                   |....................................|       +.................+         
      +--------------+                      +------------------------------------+         +-------------+           
